*****************
*P              *
*               *
*               *
*             M  *
*   M           *
*               *
*               *
*              G*
*****************